X|X|X|X|X|X|X|X|X|_|_|X|X|X|X|X|X|X|_|_|X|X|X|X|X|X|X|X|X
X|.|.|.|.|.|.|.|X|_|_|X|.|.|.|.|.|X|_|_|X|.|.|.|.|.|.|.|X
X|.|.|.|.|.|.|.|X|_|_|X|.|.|.|.|.|X|_|_|X|.|.|.|.|.|.|.|X
X|.|.|.|.|.|.|.|X|_|_|X|.|.|.|.|.|X|_|_|X|.|.|.|.|.|.|.|X
X|.|.|.|.|.|.|.|X|_|_|X|.|.|.|.|.|X|_|_|X|.|.|.|.|.|.|.|X
X|.|.|.|.|.|.|.|X|_|_|X|.|.|.|.|.|X|_|_|X|.|.|.|.|.|.|.|X
X|.|.|.|.|.|.|.|X|_|_|X|.|.|.|.|.|X|_|_|X|.|.|.|.|.|.|.|X
X|.|.|.|.|.|.|.|X|_|_|X|.|.|.|.|.|X|_|_|X|.|.|.|.|.|.|.|X
X|.|.|.|.|.|.|.|X|_|_|X|.|.|.|.|.|X|_|_|X|.|.|.|.|.|.|.|X
X|.|.|.|.|.|.|.|X|_|_|X|.|.|.|.|.|X|_|_|X|.|.|.|.|.|.|.|X
X|.|.|.|.|.|.|.|X|_|_|X|.|.|.|.|.|X|_|_|X|.|.|.|.|.|.|.|X
X|.|.|.|.|.|.|.|X|_|_|X|.|.|.|.|.|X|_|_|X|.|.|.|.|.|.|.|X
X|.|.|.|.|.|.|.|X|_|_|X|.|.|.|.|.|X|_|_|X|.|.|.|.|.|.|.|X
X|.|.|.|.|.|.|.|X|X|X|X|.|.|.|.|.|X|X|X|X|.|.|.|.|.|.|.|X
X|.|.|.|.|.|.|.|.|.|.|.|.|.|.|.|.|.|.|.|.|.|.|.|.|.|.|.|X
X|.|.|.|.|.|.|.|.|.|.|.|.|.|.|.|.|.|.|.|.|.|.|.|.|.|.|.|X
X|.|.|.|.|.|.|.|.|.|.|.|.|.|.|.|.|.|.|.|.|.|.|.|.|.|.|.|X
X|.|.|.|.|.|.|.|.|.|.|.|.|.|.|.|.|.|.|.|.|.|.|.|.|.|.|.|X
X|X|X|X|X|X|X|X|X|X|X|X|X|X|X|X|X|X|X|X|X|X|X|X|X|X|X|X|X